{ "squares" : [ { "x" : 0     , "y" : 0      ,"w" : 1600  , "h" : 30    },
                { "x" : 0     , "y" : 30     ,"w" : 30    , "h" : 840   },
                { "x" : 1570  , "y" : 30     ,"w" : 30    , "h" : 840   },
                { "x" : 0     , "y" : 870    ,"w" : 1600  , "h" : 30    },
                { "x" : 30    , "y" : 840    ,"w" : 60    , "h" : 30    },
                { "x" : 1500  , "y" : 700    ,"w" : 100   , "h" : 30    },
                { "x" : 120   , "y" : 200    ,"w" : 100   , "h" : 30    },
                { "x" : 500   , "y" : 600    ,"w" : 100   , "h" : 30    },
                { "x" : 900   , "y" : 180    ,"w" : 180   , "h" : 60    } ],
"circles" : []
}
